

F  			 155,155,0



SO					southtexture_path
R  500  500
NO  		some_path.txt
WE westpath

EA kk
C 123,23,0

S spritetexturefklfd
111111111111111111111111111111111111111111
100000000000000000000000000000000000000001
111111111111111111011111111111111011111111
100000000000000000000000000000001000000001
100000000000000001111111111111101110111101
100000000000000000000000000000100000000101
100000000000000000000000000000111111111101
100000000000000000000000000000000000000101
100000000000000000000000000000000000000111
100000000000000000000000000000000000000001
100000000000000000000000000000000000000001
100000000000000000001000000000000000000001
100000000000000000000000000000000000000001
10000000000000000000W000000000000000000001
100000000000000000000000000000000000000001
100000000000000000001000000000000000000001
100000000000000000000000000000000000000001
100000000000000000000000000000000000000001
100000000000000000000000000000000000000001
111111111111111111110011111111111111111111
100000000000000000000000000000000000000001
100000000000000000000000000000000000000001
100000000001100000000110000001100000000001
100000000000100000000100000000100000000001
100000000000100000000100000000100000000001
100000000000100000000100000000100000000001
111111111111111111111111111111111111111111
