

F  			 155,155,0



SO					southtexture_path
R  500  500
NO  		some_path.txt
WE westpath

EA kk
C 123,23,0

S 7 11 sprite.xpm
S 7 13 sprite.xpm
S 7 15 sprite.xpm

S 9 9 sprite.xpm

S 11 13 sprite.xpm
S 11 11 sprite.xpm
S 11 15 sprite.xpm
111111111111111111111111111111111111111111
100000001000000000000000000000000000000001
111110111111111111011111111111111011111111
100000000000000000000000000000001000000001
100000000000000001111111111111101110111101
100000000000000000000000000000100000000101
100000000001010100000000000000111111111101
100000000010101010000000000000000000000101
100000000100000000000000000000000000000111
10000000100W000000000000000000000000000001
100000000100000000000000000000000000000001
100000000010101010001000000000000000000001
100000000001010100000000000000000000000001
100000000000000001000001000000000000000001
100000000000000000000000000000000000000001
100000000000000000001000000000000000000001
100000000000000000000000000000000000000001
100000000000000000000000000000000000000001
100000000000000000000000000000000000000001
100000000000000000000000000000000000000001
100000000000000000000000000000000000000001
100000000000000000000000000000000000000001
100000000000000000000000000000000000000001
100000000000000000000000000000000000000001
100000000000000000000000000000000000000001
100000000000000000000000000000000000000001
100000000000000000000000000000000000000001
100000000000000000000000000000000000000001
100000000000000000000000000000000000000001
100000000000000000000000000000000000000001
100000000000000000000000000000000000000001
100000000000000011110000000000000000000001
100000000000000000000000000000000000000001
100000000000000000000000000000000000000001
100000000000000000000000000000000000000001
100000000000000000000000000000000000000001
100000000000000000000000000000000000000001
100000000000000000000000000000000000000001
100000000000000000000000000000000000000001
100000000000000000000000000000000000000001
100000000000000000000000000000000000000001
100000000000000000000000000000000000000001
100000000000000000000000000000000000000001
100000000000000000000000000000000000000001
100000000000000000000000000000000000000001
100000000000000000000000000000000000000001
100000000000000000000000000000000000000001
100000000000000000000000000000000000000001
100000000000000000000000000000000000000001
100000000000000000000000000000000000000001
100000000000000000000000000000000000000001
100000000000000000000000000000000000000001
111111111111111111110011111111111111111111
100000000000000000000000000000000000000001
100000000000000000000000000000000000000001
100000000001100000000110000001100000000001
100000000000100000000100000000100000000001
100000000000100000000100000000100000000001
100000000000100000000100000000100000000001
111111111111111111111111111111111111111111
