

F  			 155,155,0



SO					southtexture_path
R  500  500
NO  		some_path.txt
WE westpath

EA kk
C 123,23,0

T sprite.xpm
T column.xpm
T ammo.xpm

S 9 10 2

S 7 11 0
S 7 13 0
S 7 15 0

S 7 10 1
S 7 12 1
S 7 14 1

S 9 9 0

S 11 13 0
S 11 11 0
S 11 15 0

S 9 16 1


111111111111111111111111111111111111111111
100000001000000000000000000000000000000001
111110111111111111011111111111111011111111
100000000000000000000000000000001000000001
100000000000000001111111111111101110111101
100000000000000000000000000000100000000101
100000000001010100000000000000111111111101
100000000000000000000000000000000000000101
100000000100000000000000000000000000000111
10000000100W000000000000000000000000000001
100000000100000000000000000000000000000001
100000000010101010001000000000000000000001
100000000001010100000000000000000000000001
100000000000000001000001000000000000000001
100000000000000000000000000000000000000001
100000000000000000001000000000000000000001
100000000000000000000000000000000000000001
100000000000000000000000000000000000000001
100000000000000000000000000000000000000001
100000000000000000000000000000000000000001
100000000000000000000000000000000000000001
100000000000000000000000000000000000000001
100000000000000000000000000000000000000001
100000000000000000000000000000000000000001
100000000000000000000000000000000000000001
100000000000000000000000000000000000000001
100000000000000000000000000000000000000001
100000000000000000000000000000000000000001
100000000000000000000000000000000000000001
100000000000000000000000000000000000000001
100000000000000000000000000000000000000001
100000000000000011110000000000000000000001
100000000000000000000000000000000000000001
100000000000000000000000000000000000000001
100000000000000000000000000000000000000001
100000000000000000000000000000000000000001
100000000000000000000000000000000000000001
100000000000000000000000000000000000000001
100000000000000000000000000000000000000001
100000000000000000000000000000000000000001
100000000000000000000000000000000000000001
100000000000000000000000000000000000000001
100000000000000000000000000000000000000001
100000000000000000000000000000000000000001
100000000000000000000000000000000000000001
100000000000000000000000000000000000000001
100000000000000000000000000000000000000001
100000000000000000000000000000000000000001
100000000000000000000000000000000000000001
100000000000000000000000000000000000000001
100000000000000000000000000000000000000001
100000000000000000000000000000000000000001
111111111111111111110011111111111111111111
100000000000000000000000000000000000000001
100000000000000000000000000000000000000001
100000000001100000000110000001100000000001
100000000000100000000100000000100000000001
100000000000100000000100000000100000000001
100000000000100000000100000000100000000001
111111111111111111111111111111111111111111
