

F  			 155,155,0



SO					southtexture_path
R  500  500
NO  		some_path.txt
WE westpath

EA kk
C 123,23,0

T sprite.xpm
T column.xpm
T ammo.xpm




1111111
1S00001
1000001
1000001
1111111
