

F  			 3,178,98


SO assets/textures/stone.xpm
NO assets/textures/brick.xpm
R  600 600
WE assets/textures/metal.xpm

EA assets/textures/wood.xpm
C 123,23,0

S assets/sprites/sprite.xpm
S assets/sprites/column.xpm
S assets/sprites/ammo.xpm

T 10 10 2 P
T 10 11 0 I
T 10 12 0 I
T 10 13 0 I
T 10 14 0 I
T 10 15 0 I
T 10 16 0 I

T 2 3 1 P
T 2 4 1 P
T 2 5 1 P
T 2 6 1 P
T 2 7 1 P

 11111111111111111    11111111111111111111                                                             
  1000000000000001111110000000000000000001
111000001111111111000001111111111000000001
10000000000000000000000000000000100000000111111111
10N00000000000000000000000000000000000000000000001
10000000000000000000000000000000000000000111111101
100000000000000000000000000000000010000001     101
100000000000000000000200000000000000000001     101
100000000000000100000000000000100000000101     101
10000000000010000000000000000011111111110111111101
10000000000000000002000000000000000000000000000001
10000000000000000000000000000000000000000111111111
100000000000000000000000000000000000000001
100000000000000000000000000000000000000001
110000000000000000002000000000000000000001
 1000000000000000000000000000000000000000111111111111111111111111111111111111
11000000000000000000000000000000000000000100000000000000000000000000000000001
11111111110000000000000000002000000000000100111111111111111111111111111111101
         100000000000000000000000000000101001                             101
11111111110000000000000000000000000000000100111111111111111111111111111111101
10000000000000000000000000000000000000000100100000000000000000000000000000101
10000000000000000000202020200000000000000100100001111111111111111111111110101
10000000000000000000202020200000000000000100100001         11111        10101
10000000000000000000202020200000000000000100000001         10001        10101
10000000000000000000000000000000000000000100000001         10101        10101
11111111111111111000011111111111111111111111111111111111111101011111111110101
10000000000000000000000000000000000000000000000000000000000001000000000000101
10000000000000000000000000000000000000000111111111111111111111111111111111101
10000000000000000000000000000000000000000000000000000000000000000000000000001
10000000000000011110011110000000000000000111111111111111111111111111111111111
1000000000000001  1001  100000000000000111
1000000000000001  1001  100000000000000001
100000000000000111100111100000000000000001
100000000000000000000000000000000000000001
111111111110011111111111111110000000000001
11111    110000000000000000011110001111111
         111111111111111111110000000000001
                      10000000001100000001
                      10000000000000000001
                      10000000000001111111
                      10000000000000000001
                      10000000000000000001
111111111111111111111111111111110011111111
100000000000000000000000000000000000000001
100000000000000000000000000000000000000001
100000000000000000000000000000000000000001
100000000000000000000000000000000000000001
100000000000000000000000000000000000000001
100000000000000000000000000000000000000001
100000000000000000000000000000000000000001
100000000000000000000000000000000000000001
100000000000000000000000000000000000000001
100000000000000000000000000000000000000001
100000000000000000000000000000000000000001
100000000000000000000000000000000000000001
100000000111111111110000000111111111111111
100000000000000000000000000100000000000001
100000000000000000000000000100000000000001
100000000000000000000000000100000000000001
100000000000000000000000000000000000000001
100000000000000000000000000000000000000001
100000000000000000000000000000000000000001
100000000000000000000000000000000000000001
100000000000000000000000000100000000000001
100000000000000000000000000100000000000001
111111111111111111110000000100000000000001
100000000000000000000000000100000000000001
100000000000000000000000000100000000000001
111110000000001111111111111100000000000001
100000000000000000000000000000000000000001
100000000000000000000000000000000000000001
100000000000000000000000000000000000000001
100000000000000000000000000000000000000001
100000000000000000000000000000000000000001
100000000000000000000000000000000000000001
100000000000000000000000000000000000000001
111100011111111111111111111111111111100011
100000000000000000000000000000000000000001
100000000000000000000000000000000000000001
100000000001100000000110000001100000000001
100000000000100S00000100000000100000001111
100000000000100000000100000000100000001
100000000000100000000100000000100111111
1111111111111111111111111111111111
1111111111111      1  1 1 
