

F  			 155,155,0



SO assets/textures/stone.xpm
R  1024  1024
NO assets/textures/stone.xpm
WE assets/textures/stone.xpm

EA assets/textures/stone.xpm
C 123,23,0

T assets/sprites/sprite.xpm
T assets/sprites/column.xpm
T assets/sprites/ammo.xpm

S  9 16 0 H  1 0
S  15 6 0 H  1 0
S  9 20 0 H  1 0

S  9 22 1 I  1 0
S  9 23 1 I  1 0
S  9 24 1 I  1 0

111111111111111111111111111111111111111111
100000001000000000000000000000000000000001
111110111111111111011111111111111000000001
100000000000000000000000000000001000000001
100000000000000000000000000000000000000001
100000000000000000000000000000000000000001
100000000000000000000000000000000000000001
100000000000000000000000000000000000000001
100000000000000000000000000000100000000101
100000000000000000000000000000111111111101
100000000000000000000000000000000000000001
100000000000000000000000000000000000000001
100000000000000000000000000000000000000001
100000000000000000000000000000000000000001
100000000000000000000000000000000000000001
100000000000000000000000000000000000000001
100000000000000000000000000000000000000001
100000000000000000000000000000000000000001
10000N000000000000000000000000000000000101
100000000000000000000000000000000000000001
100000000000000000000000000000000000000001
100000000000000000000000000000000000000001
100000000000000000000000000000000000000001
100000000000000000000000000000000000000001
100000000000000000000000000000000000000001
111111111111111110000111111111111111111111
100000000000000000000000000000000000000001
100000000000000000000000000000000000000001
100000000000000000000000000000000000000001
100000000000000000000000000000000000000001
100000000000000000000000000000000000000111
100000000000000000000000000000000000000001
100000000000000000000000000000000000000001
100000000000000000000000000000000000000001
100000000000000000000000000000000000000001
111110000000000000000000000011110001111111
100000000000000000000000000000000000000001
100000000000000000000000000000001100000001
100000000000000000000000000000000000000001
100000000000000000000000000000000001111111
100000000000000000000010000000000000000001
100000000000000000000010000000000000000001
111111111111110001111111111111110011111111
100000000000000000000000000000000000000001
100000000000000000000000000000000000000001
100000000000000000000000000000000000000001
100000000000000000000000000000000000000001
100000000000000000000000000000000000000001
100000000000000000000000000000000000000001
100000000000000000000000000000000000000001
100000000000000000000000000000000000000001
100000000000000000000000000000000000000001
100000000000000000000000000000000000000001
100000000000000000000000000000000000000001
100000000000000000000000000000000000000001
100000000111111111110000000111111111111111
100000000000000000000000000100000000000001
100000000000000000000000000100000000000001
100000000000000000000000000100000000000001
100000000000000000000000000000000000000001
100000000000000000000000000000000000000001
100000000000000000000000000000000000000001
100000000000000000000000000000000000000001
100000000000000000000000000100000000000001
100000000000000000000000000100000000000001
111111111111111111110000000100000000000001
100000000000000000000000000100000000000001
100000000000000000000000000100000000000001
111110000000001111111111111100000000000001
100000000000000000000000000000000000000001
100000000000000000000000000000000000000001
100000000000000000000000000000000000000001
100000000000000000000000000000000000000001
100000000000000000000000000000000000000001
100000000000000000000000000000000000000001
100000000000000000000000000000000000000001
111100011111111111111111111111111111100011
100000000000000000000000000000000000000001
100000000000000000000000000000000000000001
100000000001100000000110000001100000000001
100000000000100000000100000000100000000001
100000000000100000000100000000100000000001
100000000000100000000100000000100000000001
111111111111111111111111111111111111111111
