

F  			 155,155,0



SO					assets/textures/brick.xpm
R  700  700
NO  		assets/textures/stone.xpm
WE assets/textures/wood.xpm

EA assets/textures/metal.xpm
C 123,23,0

T assets/sprites/sprite.xpm
T assets/sprites/column.xpm
T assets/sprites/ammo.xpm

S  9 16 0 H  1 0
S  9 17 0 H  1 0
S  9 18 0 H  1 0
S  9 19 0 H  1 0
S  9 20 0 H  1 0
S  9 21 0 H  1 0
S  10 22 0 H  1 0
S  11 22 0 H  1 0
S  12 22 0 H  1 0
S  13 22 0 H  1 0
S  14 22 0 H  1 0
S  15 22 0 H  1 0
S  16 22 0 H  1 0
S  17 22 0 H  1 0


111111111111111111111111111111111111111111
100000001000000000000000000000000000000001
111110111111111111011111111111111011111111
100000000000000000000000000000001000000001
100000000000000001111111111111101110111101
100000000000000000000000000000100000000101
100000000000000000000000000000111111111101
100000000000000000000000000000000000000101
100000000000000000000000000000000000000111
100000000000000000000000000000000000000001
100000000000000000000000000000000000000001
100000000000000000000000000000000000000001
100000000000000000000000000000000000000001
111110000000000000000000000011110001111111
100000000000000000000000000000000000000001
100000000000000000000000000000001100000001
100000000000000000000000000000000000000001
100000000000000000000000000000000001111111
100000000000000000000010000000000000000001
100000000000000000000010000000000000000001
111111111111110001111111111111110011111111
100000000000000000000000000000000000000001
100000000000000000000000000000000000000001
100000000000000000000000000000000000000001
100000000000000000000000000000000000000001
100000000000000000000000000000000000000001
100000000000000000000000000000000000000001
100000000000000000000000000000000000000001
100000000000000000000000000000000000000001
100000000000000000000000000000000000000001
100000000000000000000000000000000000000001
100000000000000000000000000000000000000001
100000000000000000000000000000000000000001
100000000111111111110000000111111111111111
100000000000000000000000000100000000000001
100000000000000000000000000100000000000001
100000000000000000000000000100000000000001
100000000000000000000000000000000000000001
100000000000000000000000N00000000000000001
100000000000000000000000000000000000000001
100000000000000000000000000000000000000001
100000000000000000000000000100000000000001
100000000000000000000000000100000000000001
111111111111111111110000000100000000000001
100000000000000000000000000100000000000001
100000000000000000000000000100000000000001
111110000000001111111111111100000000000001
100000000000000000000000000000000000000001
100000000000000000000000000000000000000001
100000000000000000000000000000000000000001
100000000000000000000000000000000000000001
100000000000000000000000000000000000000001
100000000000000000000000000000000000000001
100000000000000000000000000000000000000001
111100011111111111111111111111111111100011
100000000000000000000000000000000000000001
100000000000000000000000000000000000000001
100000000001100000000110000001100000000001
100000000000100000000100000000100000000001
100000000000100000000100000000100000000001
100000000000100000000100000000100000000001
111111111111111111111111111111111111111111
