

F  			 3,178,98


SO assets/textures/stone.xpm
NO assets/textures/brick.xpm
R  600 600
WE assets/textures/metal.xpm

EA assets/textures/wood.xpm
C 123,23,0

S assets/sprites/sprite.xpm
S assets/sprites/column.xpm
S assets/sprites/ammo.xpm

T 15 15 2 P
T 15 16 2 P
T 15 17 2 P
T 15 18 2 P

T 31 15 0 I
T 31 16 0 I
T 31 17 0 I
T 31 18 0 I

T 30 15 1 I
T 30 16 1 I
T 30 17 1 I
T 30 18 1 I


                   111111111                                                       
                   1001 1001
                   1001 1001
                1111001 1001111
                1000001 1000001
                1000001 1000001
             1111000001 1000001111
             1000000001 1000000001
             1000000001 1000000001
          111100000000111000000001111
          100000000000000000000000001
          100000N00000111000000000001
       1111000000000001 1000000000001111
       1000000000000001 1000000000000001
       1000000000000001 1000000000000001
    1111000000000000001 1000000000000001111
    1000000000000000001 1000000000000000001
    1111111000111111111 1111111100011111111
          10001                10001          
          10001                10001          
          10001                10001          
    1111111000111111111 1111111100011111111
    1000000000000000001 1000000000000000001
    1111000000000000001 1000202020000001111
       1000000000000001 10000000000000001
       1000000000000001110002020200000001
       1111000000000000000000000000001111
          1000000000001110002020200001
          1000000000001 10000000000001
          1111000000001 10002020201111
             1000000001 10000000001
             1000000001 10000000001
             1111000001 10000001111
                1000001 10000001
                1000001 10000001
                1111001 10001111
                   1111111111               1                         

